Microsoft -> Microsoft Corporation
VMware -> VMware Inc.
Huawei -> Huawei Technologies Co. Ltd.
Facebook -> Facebook Inc.
SUSE -> SUSE LLC
NetEase -> NetEase Inc
Docker -> Docker Inc.
Samsung -> Samsung Electronics Co. Ltd.
Mirantis -> Mirantis Inc.
CloudBees -> CloudBees Inc.
Dell -> dell
SalesForce -> Salesforce.com
Linaro -> Linaro Limited
Canonical -> Canonical Ltd.
GitHub -> GitHub Inc.
EPAM -> EPAM Systems
eBay -> eBay Inc.
Datadog -> Datadog Inc.
Heptio -> Heptio Inc.
Adobe -> Adobe Systems Inc.
NVidia -> NVIDIA Corporation
Tencent -> Tencent Holdings Limited
Yahoo -> Yahoo! Inc.
Atlassian -> Atlassian Inc.
CloudFlare -> CloudFlare Inc.
Splunk -> Splunk Inc.
Spotify -> Spotify Sweden AB
Rancher Labs -> Rancher Labs Inc
Square -> Square Inc.
LinkedIn -> LinkedIn Corporation
DaoCloud -> DaoCloud (Shanghai DaoCloud Network Technology Co LTD)
NetApp -> NetApp Inc.
Intuit -> Intuit Inc.
CloudByte -> CloudByte India Technologies Pvt. Ltd.
AT&T -> AT&T Services Inc.
Nordic Semiconductor -> Nordic Semiconductor ASA
New Relic -> New Relic Inc.
Baidu -> Baidu Online Network Technology (Beijing) Co. Ltd
Broadcom -> Broadcom Corporation
Capital One -> Capital One Services Inc.
NEC -> NEC Corporation
Citrix -> Citrix Systems Inc.
Texas Instruments -> Texas Instruments Incorporated
SoundCloud -> SoundCloud Limited
Dynatrace -> Dynatrace LLC
Elastic -> Elasticsearch Inc.
Treasure Data -> Treasure Data Inc.
Puppet -> Puppet Inc.
Kinvolk -> Kinvolk GmbH
Heroku -> Heroku Inc.
CoreOS -> CoreOS Inc.
Buoyant -> Buoyant Inc.
Infoblox -> Infoblox Inc.
Walt Disney -> Walt Disney Animation Studios
China Mobile -> China Mobile Communication Company Ltd
NXP -> NXP Semiconductors Netherlands B.V.
Rakuten -> Rakuten Inc.
Siemens -> Siemens AG
Expedia -> Expedia Group
Apprenda -> Apprenda Inc.
Palantir -> Palantir Technologies
Stripe -> Stripe Inc.
EasyStack -> EasyStack Inc.
NTT -> NTT Corporation
Akamai Technologies -> Akamai Technologies Inc.
CyberAgent -> Cyberagent Inc.
Cloudera -> Cloudera Inc.
Schibsted -> Shibsted Products & Technology
Wind River -> Wind River Systems Inc.
Lightstep -> LightStep Inc.
MIT -> MIT Connection Science
Cerner -> Cerner Corporation
Cockroach -> Cockroach Labs
Symantec -> Symantec Corporation
Marvell -> Marvell International Ltd
Parallels -> Parallels Research
Platform9 -> Platform9 Systems Inc.
Big Switch Networks -> Big Switch Networks Inc.
Ghostcloud -> Ghostcloud Technology Co. Ltd
Luxoft -> Luxoft Global Operations GmbH
Workiva -> Workiva Inc.
Chef -> Chef Software Inc.
Nike -> Nike Inc.
Qiniu -> Qiniu Limited
Gojek -> GOJEK
Synadia -> Synadia Communications
ST Microelectronics -> ST Microelectronics Srl
Kong -> Kong Inc.
Braintree -> Braintree Payments
Barefoot -> Barefoot Networks Inc.
AMD -> Advanced Micro Devices Inc.
Upwork -> oDesk Corporation
Tetrate -> Tetrate.io
GitLab -> GitLab Inc.
Deloitte -> Deloitte New Zealand
ContainerSolutions -> Container Solutions
Western Digital -> Western Digital Corporation
AppsCode -> AppsCode Inc.
SoftServe -> Soft Serve Inc.
JFrog -> JFrog Inc.
inovex -> inovex GmbH
Intuit -> Intuit
Innuit -> Intuit
Mentor Graphics -> Mentor Graphics Corporation
Wipro -> Wipro Limited
F5Networks -> F5 Networks Inc.
Metaswitch -> Metaswitch Networks
PLUMgrid -> PLUMgrid Inc.
Deutsche Bank -> Deutsche Bank AG
Cookpad -> Cookpad Inc. (UK)
Hortonworks -> Hortonworks Inc. ( acquired by Cloudera)
Armory -> Armory Inc
Nordstrom -> Nordstrom Inc.
Seagate -> Seagate Technology LLC
GlobalLogic -> GlobalLogic Inc.
Two Sigma -> Two Sigma Investments LP
Espressif Systems -> Espressif
Quantum -> Quantum Corporation
Thomson Reuters -> Thomson Reuters Markets LLC
PlayStation -> Sony Interactive Entertainment LLC
Booking.com -> Booking.com B.V.
Box -> Box Inc.
Etsy -> Etsy Inc.
npm -> npm Inc.
Arista -> Arista Networks
Tieto -> TietoEVRY
Renesas Technology -> Renesas Electronics Corporation
Devops -> DevOps Institute
DeNA -> Dena Corp
OVH -> OVH SAS
Inria -> Inria (French Institute for Research in Computer Science and Automation)
Booking -> Booking.com B.V.
Portworx -> Portworx Inc.
Toptal -> Toptal LLC
Ciena -> Ciena Corporation
Xilinx -> Xilinx Inc.
Open Networking Foundation (ONF) -> Open Networking Foundation
Bootlin -> Free Electrons
Nutanix -> Nutanix Inc.
Lenovo -> Lenovo (United States) Inc.
Oticon -> Oticon A/S
Joyent -> Joyent Inc.
Midokura -> Midonet/Midokura
Riverbed -> Riverbed Technology Inc.
OPPO -> Guangdong OPPO Mobile Telecommunications Corp. Ltd.
Ant Financial -> ant group
Engine Yard -> Deis Inc. (EngineYard)
Iron.io -> Iron.io Inc.
CodiLime -> CodiLime Sp. z o.o.
HCL -> HCL Technologies Ltd.
InfraCloud -> Infracloud Technologies INC
ADP -> Automatic Data Processing Inc.
Fairfax Media -> Fairfax
ClusterHQ -> ClusterHQ Inc
InfluxData -> InfluxData Inc
Liferay -> Liferay Inc.
Hulu -> Hulu LLC
Jet -> Jet.com
Societe Generale -> Société Générale
Couchbase -> Couchbase Inc.
Lookout -> Lookout Inc
Honeywell -> Honeywell International
Amdocs -> Amdocs (Development Limited)
Camptocamp -> Camptocamp SA
AppDynamics -> AppDynamics LLC
Seznam -> Seznam.cz a.s.
Linkedln -> LinkedIn Corporation
Shutterstock -> Shutterstock Images LLC
Return Path -> Return Path Inc.
Seznam.cz -> Seznam.cz a.s.
NASA -> NASA Ames Research Center
Atmel -> Atmel Corporation
GoCardless -> GoCardless Ltd
Spectro Cloud -> Spectro Cloud Inc
SysEleven -> SysEleven Gmbh
XSky -> XSKY Cooperation
Lawrence Livermore National Laboratory -> Lawrence Livermore National Laboratory (LLNL)
Zillow -> Zillow Inc.
The New York Times -> New York Times
H3C -> New H3C Technologies Co. Ltd.
Aetna -> Aetna Inc.
Informatica -> Informatica Corporation
Fitbit -> Fitbit Inc.
Staples -> Staples Inc.
The Home Depot -> Home Depot Inc.
MediaTek -> MediaTek USA Inc.
TriggerMesh -> TriggerMesh Inc.
BlackRock -> BlackRock Financial Management
FactSet -> FactSet Research Systems Inc.
ISP RAS -> Ivannikov Institute for System Programming of the RAS
Gravitational -> Gravitational Inc.
MIPS -> MIPS Technologies
Meltwater -> Meltwater Group
EY -> Ernst & Young
TrendMicro -> Trend Micro Incorporated
Node.js -> Node.js Foundation
Math Works -> The MathWorks INC
T-Mobile -> T-Mobile PCS Holdings LLC
A.P. Moller - Maersk -> Maersk
LG -> LG Electronics
Google Summer of Code -> Google
Sourcegraph -> Sourcegraph Inc
Snap -> Snap Snap
Perforce -> Perforce Software Inc.
Node -> Node.js Foundation
DXC -> DXC Technology
Citadel -> Citadel LLC
UBS -> UBS Business Services AG
Telefónica -> Telefonica
Vulk -> Vulk Coop
ANZ -> ANZ Banking Group Ltd.
Nordea -> Nordea Bank
Scout24 -> Scout24 AG
TD -> TD Bank Financial Group
WSO2 -> WSO2 Inc.
Cumulus -> Cumulus Networks Inc.
CA -> CA Technologies
Brocade -> Brocade Communications Systems LLC
athenahealth -> athenahealth Inc.
HarmonyCloud -> Hangzhou HarmonyCloud Technology LTD.
Hasura -> Hasura Technologies
Avaya -> Avaya Inc.
Replicated -> Replicated Inc.
InVision -> InVision AG
Motorola -> Motorola Mobility Inc.
Wix -> Wix.com Ltd
Talend -> Talend Inc.
Netronome -> Netronome Systems Inc.
Allianz -> Allianz Deutschland AG
Epic -> Epic Systems
99cloud -> 99Cloud Inc.
Fairway Technologies -> Accenture plc
NYU -> NYU Langone Medical Center
Quantcast -> Quantcast Corporation
Claranet -> Claranet Ltd.
Outfittery Gmbh -> OUTFITTERY
Optum -> Optum/UnitedHealth Group
Cray -> HPE
Globo.com -> Globo
Andela -> Andela Inc.
Elastisys -> Elastisys AB
Eficode -> Eficode Oy
D2SI -> Devoteam Revolve
Sandvine -> Sandvine Incorporated
Antmicro -> ANTMICRO LTD
Bull -> Bull HN Information Systems Inc.
Tumblr -> Tumblr Inc.
Jive -> Jive Software Inc.
World Wide Technology -> World Wide Technology Inc.
Opera -> Opera Software ASA
UMCloud -> UCloud Information Technology (HK) Limited
Analog Devices -> Analog Devices Inc.
AXA -> AXA Financial Inc.
Altiscale -> Altiscale Inc.
Aruba -> Aruba Networks HPE
Datera -> Datera Inc.
STMicroelectronics -> STMicroelectronics International N.V.
Preferred Networks -> Preferred Networks Inc.
GSA -> General Services Administration
Ctrip -> Ctrip car rental Department
Black Duck -> Black Duck Software Inc.
Odecee -> Odecee Careers
HTC -> HTC America
Thought Machine -> Thought Machine Group Ltd.
Credit Karma -> Credit Karma Inc.
Acronis -> Acronis Inc.
LivePerson -> LivePerson Inc.
Vonage -> Vonage Holdings Corp.
Bentley -> Bentley Motors Limited
Esri -> Esri Northeast Africa
ocadotechnology -> Ocado
Kenzan -> Kenzan Media LLC
Kohl's -> Kohl's Corporation
Murex -> MUREX SAS
Barracuda -> Barracuda Networks Inc.
Juno -> juno
Opendoor -> Opendoor Labs Inc
HM Revenue & Customs -> HM Revenue and Customs (HMRC)
Zulily -> Zulily Inc.
Cvent -> Cvent Inc.
Dailymotion -> DAILYMOTION SA
BMC -> BMC Software Inc.
JetBrains -> JetBrains s.r.o.
Zuora -> Zuora Inc.
Databricks -> Databricks Inc.
Presto Software Foundation -> Presto
Cybercom -> Cybercom Group AB
HP Enterprise -> HP
YLD -> YLD! Limited
1&1 -> 1&1 IONOS
Digital Asset -> Digital Asset Holdings LLC
Helios -> Helios Watch Store
finleap connect -> finleap connect GmbH
Anchorage -> Anchor Labs Inc
Kony -> Kony Solutions Inc.
McAfee -> McAfee LLC
CollabNet -> CollabNet VersionOne
B1 Systems -> B1 Systems GmbH
Continental -> Continental AG
Chelsio -> Chelsio Communications
FINkit® is Fiserv -> FINkit
Blue Box -> Blue Box Group
MapR -> MapR Technologies
Stakater -> Stakater AB
PTC -> Parametric Technology Corporation
Codefresh -> Codefresh Inc.
Blackbaud -> Blackbaud Inc.
Witekio -> Witekio Holding
Wise2c -> Shenzhen Wise2C Technology Co.Ltd
National Instruments -> National Instruments Corporation
Betsson -> Betsson Group
Atomist -> Atomist Inc.
Zynga -> Zynga Inc.
Novell -> Novell Japan Ltd
NuoDB -> NuoDB Inc.
ProfitBricks -> ProfitBricks Inc.
Ping Identity -> Ping Identity Corporation
Babylon Health -> Babylon Partners Ltd
Stark & Wayne -> Stark & Wayne LLC
Mirakl -> MIRACL UK Limited
Telstra -> Telstra Corporation Limited
Lohika -> Lohika Systems Inc.
GfK -> GfK SE
Optimizely -> Optimizely Inc.
Quantenna -> Quantenna Communications Inc
Okta -> Okta Inc.
QingCloud -> QingCloud Technologies Corp.
Chegg -> Chegg Inc.
UnitedHealth -> UnitedHealth Group
DataStax -> DataStax Inc.
Mattermost -> Mattermost Inc.
Jiff -> Jiff Inc.
YPlan -> Time Out England Limited
MediaMath -> MediaMath Inc.
HARMAN -> Harman International Industries Inc.
Hasso -> Hasso Plattner Institute for Software Engineering
Kainos -> Kainos Software
Mentor -> Mentor Graphics Corporation
Sonatype -> Sonatype Inc.
Schibsted Media -> Shibsted Products & Technology
IDT -> Integrated DNA Technologies Inc
DataArt -> DataArt Solutions Inc. DBA: DeviceHive
Calsoft -> Calsoft Inc.
Groupe SII -> SII Services
Fairwinds -> Fairwinds Ops Inc
OpenText -> Opentext Inc.
Fire Eye -> FireEye
Barco -> Barco Inc.
Typesafe -> Lightbend Inc
State Farm -> State Farm Mutual Insurance Company
IPsoft -> IPsoft Inc.
ZEIT -> Zeit
Soluto -> Soluto Engineering
Examplempany -> chakra
Anchore -> Anchore Inc.
Pramati -> Pramati Prism Inc.
Ustream -> Ustream Inc.
Jimdo -> Jimdo GmbH
CloudOps -> CloudOps Inc.
Kronos -> Kronos Incorporated
Netcracker -> Netcracker Technology Corporation
Nasdaq -> Nasqad Inc.
Zoho -> Zoho Corporation
Nuance Communications -> Nuance Communications Inc.
Veracode -> Veracode Inc.
Virtusa -> Virtusa Corporation
Snyk -> Snyk Ltd.
OCTO -> OCTO Technology
Panasonic -> Panasonic Corporation
Nuance -> Nuance Communications Inc.
Worldpay -> Worldpay INC
Robinhood -> Robinhood Financial LLC
Neo4j -> Neo4j Inc.
ExtraHop -> ExtraHop Networks
Odin -> Odin Health
Tube Mogul -> Adobe Inc.
Tech Mahindra -> Tech Mahindra Ltd.
Asiainfo -> Asiainfo Technologies (China)  Inc.
Infor -> INFOR US INC
Government Digital Service -> Goverment Digital Service
Namecheap -> Namecheap Inc.
NICE -> NICE Netherlands B.V.
Infineon -> Infineon Technologies AG
LiveRamp -> LiveRamp Inc
LINE Corp -> LINE Corporation
sky-uk -> Sky
SIGHUP -> SIGHUP s.r.l.
SAS -> SAS Institute
IGT -> International Game Technology
StorageOS -> StorageOS Ltd
tencent -> Tencent Holdings Limited
Snowflake -> Snowflake Computing Inc.
Shell -> Shell International Petroleum Company
HGST -> HGST Inc.
ContainerShip -> Containership Inc
PernixData -> Nutanix Inc.
Paytm -> Paytm Labs
Singular -> SINGULAR MACHINERY
Tyk -> Tyk Technologies Ltd.
Extreme Networks -> Extreme Networks Inc.
BNY Mellon -> Bank of New York Mellon
Appian -> Appian Corporation
Ancestry -> Ancestry.com Inc.
Cloud Foundry -> Cloud Foundry Foundation
Rewe Digital -> REWE Digital GmbH
Sophos -> Sophos Ltd.
MathWorks -> MathWorks Inc.
Macquarie -> Macquarie Group USA
Twistlock -> Twistlock Inc.
Fiserv -> Fiserv Inc.
ISCAS -> Institute of Software Chinese Academy of Science
Bandwidth -> Bandwidth.com Inc.
Condé Nast -> Conde Nast International
Anaconda -> Anaconda Inc
Solarflare Communications -> Solarflare Communications Inc.
Acquia -> Acquia Inc.
Blackduck -> Black Duck Software Inc.
Temenos -> Temenos Group USA
Israel Defense Forces -> The Israel Defense Forces
Outbrain -> Outbrain Inc.
Matrix -> Wikipedia
Barnes & Noble -> Barnes & Noble.com
Aqua Security -> Aqua Security Software Inc.
Telus -> TELUS Communications Inc.
Bottomline -> Bottomline Technologies Inc.
Ceph -> Cephas Security Solutions
Fusion-io -> Fusion-io Inc.
Status -> StatusNet
Liquid Web -> Liquid Web Hosting Inc.
Oath -> Oath Inc. dba Verizon Media
FIS -> Fidelity Information Services
InMobi -> InMobi USA
QLogic -> QLogic Corporation
Kasten -> Kasten Inc.
RealPage -> RealPage Inc.
Volterra -> Volterra Inc
Qbox -> Qbox (Supergiant)
Praekelt -> Praekelt.org
Fortinet -> Fortinet Inc.
CIBC -> CIBC Mellon
NewStore -> Newstore Inc.
Collective Health -> Collective Health Inc.
Bitium -> Bittium
Visteon -> Visteon Innovation and Technology GmbH
dunnhumby -> Dunnhumby Ltd
PubNub -> PubNub Inc.
Indigitus -> Indigitous
BoxBoat -> BoxBoat Technologies
Financial Times -> The Financial Times Limited
Shutterfly -> Shutterfly Inc.
Viavi Solutions -> Viavi Solutions Inc.
Garmin -> Garmin International Inc.
Camunda -> Camunda Services GmbH
8x8 -> 8x8 Inc.
Hubrick -> Hubrick Limited
takealot -> Takealot.com
Xoom -> Xoom Corporation
Workshare -> Litera Corp.
FreshTracks -> FreshTracks.io (CA INC)
DiDi -> Xiaoju Science Technology (Hong Kong) Limited
iWeb -> iWeb Hosting
Gremlin -> Gremlin Inc.
Jane Street -> Jane Street Capital
Sberbank -> Sberbank Corporate University
CSIRO -> CSIRO/DATA 61
Social Point -> Social Point S.L.
NXP acquires Freescale Semiconductor -> NXP Semiconductors Netherlands B.V.
Imgur -> Imgur: The magic of the Internet
Schlumberger -> Schlumberger Limited
Trendyol -> Trendyol Group
6WIND -> 6WIND S.A.
Fon -> Fon Wireless Limited
MSB -> Magic Sandbox (MSB)
Konsulko -> Konsulko Group
DigitalGlobe -> DigitalGlobe Inc.
Telenor Digital -> Telenor
Coastal Pacific Crane & Hoist Engineering -> CP Cranes
Transwarp -> Transwarp Technology (Shanghai) Co. Ltd
Namely -> Namely Inc.
draios -> Sysdig
DFINITY -> DFINITY Foundation
Points -> Points.com Inc
Avvo -> Avvo Inc.
EveryQuote -> EverQuote Inc.
Persistent -> Persistent Systems
MangoDB -> MongoDB
Mail.Ru -> Moscow Design Bureau - Compas
Comarch -> Comarch S.A.
Yodle -> Yodlee Inc.
SapientRazorfish -> Publicis Sapient
Smartsheet -> Smartsheet.com
Autoliv -> Autoliv Inc. US
Epic Games -> Epic Games Inc.
Radisys -> Radisys Corporation
Isotoma -> Isotoma Limited
MontaVista -> MontaVista Software LLC
Trimble -> Trimble Inc.
Right Scale -> Flexera Software LLC
Zerodha -> Zerodha Broking Limited
PostFinance -> PostFinance AG
Glia -> Glia Technologies Inc
Ninety Percent of Everything -> OpenOcean Studio
OSRAM -> OSRAM SYLVANIA Inc
Myndshft -> Myndshft Technologies Inc.
Cognito -> Cognito iQ
Travel Audience -> travel audience
Pegasystems -> Pegasystems Inc.
Progress -> Progress Software Corporation
uShip -> uShip Inc.
Natunix -> Nutanix Inc.
HBO -> HBO Inc.
Atlas Copco -> Atlas Copco AB
Synamedia -> Synamedia Vividtec Holdings Inc.
Desjardins -> Desjardins Group
ConsenSys -> ConsenSys AG
Quest Software -> Quest
Tenaris -> Tenaris Global Services Corp.
Visma -> Visma Connect BV
Geofeedia -> Geofeedia Inc.
Domino Data -> dominodatalab.com
Fraunhofer IAIS -> Fraunhofer-Gesellschaft
MOO -> MOONDA
Yik Yak -> yilyak
NXP Semiconductors -> NXP Semiconductors Netherlands B.V.
CSG -> CSG International Inc.
BNP -> BNP Paribas
Alert Logic -> Alert Logic Inc.
Novatec -> NovaTech
BAE -> BAE Systems
Zoox -> Zoox in.
TELUS -> TELUS Communications Inc.
SW Maestro -> SWM
Fractal Innovations -> Fractal
AirMap -> AirMapInc.
OpenX -> OpenX Technologies Inc.
H-E-B -> HEB
17media -> 17LIVE
Amaris -> Amaris Lusa LDA
Orion Health -> Orion Health Inc.
linutronix -> Linutronix GmbH
E.ON -> Eon Cloud
JPMorgan -> JPMorgan Chase
Yext -> Yext Inc.
Workfront -> Workfront Inc.
NGINX -> NGINX International Limited
Hotelscan -> hotelscan
Hyland -> Hyland Software Inc.
Sutherland -> Sutherland Global Services
ACI Worldwide -> ACI Worldwide Inc.
CoverMyMeds -> CoverMyMeds LLC
SICPA -> SICPA SA
TNG Technology -> TNG
JumpCloud -> JumpCloud Inc.
Buni Hub -> eBike Focus
Astek -> Astek Corporation
Grupa Wirtualna Polska -> Wirtualna Polska
Y Soft -> Y Soft Corporation a.s.
World Wide -> World Wide Technology Inc.
Click Fox -> BryterCX
Sky Betting&Gaming -> Hestview Limited
ETRI -> Electronics and Telecommunications Research Institute (ETRI)
HomeAway -> HomeAway.com Inc.
Mail.ru -> Moscow Design Bureau - Compas
Nine -> Nine Entertainment Co. Holdings Limited
Scoop -> Scoop Technologies
LeafLabs -> LeafLabs LLC
Melanomore -> MelaNoMore
Zooplus AG -> zooplus
UrtheCast -> UrtheCast Corp
Liberty Global -> Liberty Global Inc.
Zeppelin -> Zeppelin Group
Move -> Move Inc.
Coraid -> Coraid Inc.
Ishi -> Ishi Systems Inc
Cloudius Systems -> Cloudius Systems LTD.
Imperva -> Imperva Inc.
UK Home Office -> HM Revenue and Customs (HMRC)
FRIDAY Versicherung -> Deutsche Niederlassung der FRIDAY Insurance S.A.
Serena Software -> Serena Software Inc.
N26 -> N26 GmbH
Express Scripts -> Express Scripts Inc.
SoFi -> Social Finance (SoFi)
TCS -> Tata Consultancy Services
CloudCredo -> CloudCredo Limited
Marks and Spencer -> Aftoo
Trainline -> Trainline plc
Cloudian -> Cloudian Inc.
CasparCG -> CasparCG GFX & Video
Medicity -> Medicity Speciality Laboratory
CDW -> CDW Corporation
Covata -> Covata Limited
Bank of America -> Bank of America Corporation
Ahold Delhaize -> Ahold Delhaize USA
Cloudsoft -> Cloudsoft Corporation Ltd
Rockchip -> rock chips
Sauce -> Sauce Labs
Toast -> Toastmasters International
Workable -> Workable Inc
PDT Partners -> PDT Partners LLC
Ctrip.com -> Ctrip car rental Department
Crunchy Data -> Crunchy Data Solutions Inc.
Applause -> Applause Inc.
Revolv -> Revolv Inc.
China Unicom Cloud Data -> China Unicom
Kakao -> kakaobank
X-ion -> Xion Protective Gear
Collibra -> Collibra Connect
Wikimedia -> Wikimedia Foundation
Tuxera -> Tuxera Inc.
Walmart eCommerce -> Walmart
TCF Bank -> TCF Financial
IKEA -> IKEA IT AB
The Apache Software Foundation -> Apache Software Foundation
FreakOut -> FreakOut Inc.
Infinity Works -> Infinity Works Consulting Ltd.
Goldstar Events -> Goldstar Events Inc.
Softplan Planejamento e Sistemas -> Softplan
greymatter.io -> Grey Matter
Starbucks -> Starbucks Corporation
Ubiquiti -> Ubiquiti Inc.
ZipRecruiter -> ZipRecruiter.com
Delphi -> Delphi Electronics & Safety
Fraunhofer -> Fraunhofer-Gesellschaft
Toshiba -> Toshiba Corporation
BlueCat -> BlueCat Networks
JPMorgan Chase & Co. -> JPMorgan Chase
VSHN -> VSHN AG
WebSumit -> Connected Intelligence Limited
Teamwork -> Teamwork.com
Cloud Niners -> Cloud9ers
Tavisca Solutions -> Tavisca LLC
Arimo -> Arimo LLC
orijtech -> Orijtech
Newegg -> Newegg Inc.
Deutsche -> Deutsche Bank AG
Convergys -> Convergys Corporation
Storm Reply -> Storm Reply GmbH
Bugsnag -> Bugsnag Inc
Mixpanel -> Mixpanel Inc.
ShareThis -> Sharethis Inc
AirTies -> AirTies Wireless Networks
Hearsay -> Hearsay Social
X the moonshot factory -> X the moonshot factory
L&T -> L&T Infotech
CAPSiDE | NTT -> CAPSiDE UK Ltd
Innovating Tomorrow -> Innovating Tomorrow  LLC
Amplidata -> Quantum Corporation
Commerzbank AG -> Commerzbank
Rangle.io -> Rangle
Nginx -> NGINX International Limited
Zesty.io -> Zesty.IO Platform Inc
Veniam -> Veniam Inc.
Anaplan -> Anaplan Inc.
SunGard -> Fidelity National Information Services Inc.
BlueJeans by Verizon -> Verizon
Ally -> Welch Allyn
EUIPO -> EUIPO - European Union Intellectual Property Office
ASML -> ASML US Inc.
Keysight -> Keysight Technologies Inc.
BroadSoft -> BroadSoft Inc
ProphetStor Data Services -> ProphetStor
O'Reilly Media -> OReilly Media
Handshake -> Handshakerp
Banco do Brasil -> Banco do Brasil S/A.
WebShar -> WebShar India Pvt Ltd
Fujitsu Global -> Fujitsu Limited
EverQuote -> EverQuote Inc.
Pickn -> PicknGo
Greenhouse -> Greenhouse Software
ComScore -> comScore Inc.
MinIO -> Minio
Comscore -> comScore Inc.
Vail Systems -> HighVail Systems
Robert Half -> Robert Half International
Kii -> Kii Corporation
Harris -> Harris Corporation
Teletronics -> Teletronics International
Canvas Medical -> Canvas
Deutsche Telekom Pan-Net -> Deutsche Telekom
Sysco -> SYSCO Corporation
U-blox -> u-blox AG
KMS Technology -> KMS Technology Inc.
The WebRoot -> Webroot Inc.
Nomura -> Nomura Group
Socialpoint -> Social Point S.L.
DG-i KG -> Dembach Goo Informatik GmbH & Co. KG
Zoover & Weeronline -> Weeronline
Accton -> Accton Technology Corporation
LINAGORA -> Liagora
unu -> UNU-MERIT
Textron -> Textron Inc.
JLL -> JLL (Jones Lang LaSalle Incorporated)
Wix.com -> Wix.com Ltd
Control Plane -> ControlPlane
Figure Eight -> Appen
Arctiq -> Arctiq Inc.
Yoyo -> Yoyo Holdings
Inbox -> PowerInbox
Faraday -> Faraday Technology Corporation
Skyscrapers -> the skyscraper center
SolidFire -> Solidfire Inc.
Widen -> Widen Enterprise
Saama -> Saama Technologies Inc.
PARC -> Palo Alto Research Center
Kik -> Kik Interactive
xFlow Research -> xFlow Research.com
Bilibili Group -> bilibili Group
Shiguredo -> Shiguredo Inc
Connectifier -> LinkedIn Corp.
Redes -> Grupo de Redes
Treasure -> Treasure Data Inc.
ACM -> ACM-Sahyadri
clibs -> clib
Concur -> Concur Technologies Inc.
Pôle emploi -> DSI of Pôle Emploi
iHerb -> iHerb LLC
Daugherty -> Daugherty Business Solutions
GFT -> GFT Technologies SE
Klinche -> hugedomains
Mendix -> Mendix Inc.
Go-Jek -> GOJEK
Welltok -> Welltok Inc.
LendingClub -> Lending Club
Skilld -> SkillD India
TigerWorks -> Tiger Works
BGDev -> BG Development
DevOps -> DevOps Institute
PearsonVUE -> Pearson VUE
Acision -> Acision Czech Republic sro
Limelight -> Limelight Networks
Tokopedia -> PT Tokopedia
ProKarma -> ProKarma Inc.
Lever -> Lever Inc.
Gandi -> gandi.net
Internet Initiative Japan -> Internet Initiative Japan Inc.
Worldline -> SIA Worldline Latvia
Paychex -> Paychex Inc.
Humana -> Humana Inc.
Brightcove -> Brightcove Inc.
Metacloud -> MetaCloud Inc
Kayla -> KaylaTek
Wavefront by VMware -> Wavefront
Renault Digital -> Renault
CSG International -> CSG International Inc.
Neusoft -> Neusoft Corporation
GIA -> Gemological Institute of America Inc.
DroneDeploy -> Drone Deploy
Digital Transformation -> Digital Transformation University LTD
Radware -> Radware Inc.
BeringPoint Technology -> BearingPoint GmbH
Predic8 -> predic8
Tradeweb -> Tradeweb Markets LLC
Maredit -> MarcEdit Development
Nicira -> Nicira Networks Inc.
Earnest -> Earnest Operations
Verisk Financial | Retail Solutions -> Verisk
KPMG AG Wirtschaftsprüfungsgesellschaft -> KPMG
Brightbox -> Bright Box Limited
Athenahealth -> athenahealth Inc.
Datica -> Datica Health Inc
Principal -> Principal Financial Services Inc.
Zengularity -> Fabernovel
Shoop -> LinkedIn Corp.
YOOX NET-A-PORTER -> YOOX NET A PORTER GROUP SPA
VexxHost -> VEXXHOST Inc.
Ubie -> UBIO
LiveWyer -> LiveWyer Ltd
Commonwealth Computer Research -> Commonwealth Computer Research Inc.
Akka -> Akka.NET
Vestas -> Vestas Americas
Israeli Air Force -> IAF - Israeli Air Force
Tenable -> Tenable Network Security Inc.
Social Magnetics -> Social Magnets
Wallmob -> Extenda Go
Walmart Global -> Walmart
Verint -> Verint Systems Inc.
Ripple -> Ripple Inc.
Nefeli Network -> Nafeli Networks
Med Bridge -> MedBridge S. C.
REWE Digital -> REWE Digital GmbH
Daynix Computing -> Daynix Computing LTD
blackrock -> BlackRock Financial Management
Archlinux -> Arch Linux
Spirent -> Spirent Communications Inc
Stem -> Stem Inc
Computacenter -> Computacenter AG & Co OHG
OverOps -> OverOps Inc.
Alstom -> Alstom Group
Amazon Web Services (AWS) -> Amazon
Knewton -> Knewton Inc.
Quagga -> Windstream Communications
Datalink -> Datalink Corporation
Blockstack -> Blockstack Inc.
Bose -> Bose Corporation
TSMC -> TSMC (TAIWAN SEMICONDUCTOR MANUFACTURING COMPANY LIMITED)
treasure-data -> Treasure Data Inc.
Tracelytics -> AppNeta
Dexcom -> Dexcom Inc.
Tecbeast -> TecBeast Software Development Company
Savoir-faire -> Savoir-faire Linux
Pegasus -> Pegasus Solutions Inc.
Adorsys -> adorsys GmbH & Co. KG
CESNET -> CESNET a.l.e.
SAP Ariba -> Ariba Inc.
Jaguar Land Rover -> Jaguar Land Rover Ltd.
Seller -> DBSeller Sistemas Integrados
Pork industries -> pork checkoff
Securian Financial -> Securian Financial Group Inc.
SASTRION -> Tracxn Technologies Private Limited
Irdeto -> Irdeto USA Inc.
ZITiS -> service.bund.de
HomeAway.com -> HomeAway.com Inc.
Altos -> Altos Computing Inc.
Next Pathway -> Next Pathway Inc.
Hacker's Den -> Hackers Den
T-Systems Multimedia Solutions -> T-Systems
Musikum E.V. -> musikum
BearingPoint -> BearingPoint GmbH
IBM Aspera -> Aspera
Scott Logic -> Scott Logic Ltd
Amesys -> AMSYS
AvidXchange -> AvidXchange Inc.
CCC -> CCC Information Services Group
Aptio -> Apptio
Veeva Systems -> Veeva Systems Inc.
Tag1 -> Tag1 Consulting Inc.
Thinkful -> Thinkful Inc.
Cradlepoint -> Cradlepoint Inc
Blue State Digital -> Blue State Digital Inc
Runtastic -> Runtastic GmbH
HPE SimpliVity -> SimpliVity
Spring -> SpringSource Inc.
Misys -> Misys US
Coriant -> Coriant GMBH
Code42 -> Code 42 Software
CommScope -> CommScope Inc.
Internet Mall -> MallGroup
Showbox -> Showbox (acquired by Powtoon)
Infobip -> lnfobip d.o.o
MemSQL -> MemSQL Inc.
Moltin -> Elastic Path Software Inc
Scalec -> SCALEC
StackEngine -> StackEngine (now owned by Oracle)
Major -> Major League Baseball
Neustar -> Administrative Services LLC A Neustar Company
John Lewis Partnership -> John Lewis Partnership plc
MyFitnessPal -> MyFitnessPal LLC
Finnova -> finnova AG Bankware
RackN -> RackN Inc.
Vyatta -> Vyatta Inc.
Abto -> Abto Software
Embrane -> Cisco Systems Inc.
DISH Network -> DISH Network Corporation
AstraZeneca -> AstraZeneca Pharmaceuticals
Liberty Mutual Insurance -> Liberty Mutual Insurance Company
Lifion by ADP -> Lifion
s1network -> S1 Network Solution
Macadamian -> Macadamian Technologies
Clarity Business Solutions -> Clarity
Open Listing -> Opendoor Labs Inc
Edmunds -> Edmunds.com Inc.
Bull SAS -> Atos
Cargill -> Cargill Inc.
Middleware360 Solutions -> Middleware360 Solutions Inc.
UOL -> UOL DIVEO
AdNovum Informatik AG -> AdNovum
Stack.Build -> Stack Build
App Neta -> AppNeta
Department for Work and Pensions -> HMPO
Telekom -> Deutsche Telekom AG
Candide -> Candide Gardening
Henkel -> Henkels & McCoy Inc.
Vue -> HireVue
Kalon -> Kalon Couture
实地地产 -> SEEDLAND
Rodeo FX -> RodeoFX
DataCentred -> DataCentred Ltd
BUPT -> Beijing University of Posts and Telecommunications (BUPT)
3scale -> 3scale Inc
garden.io -> Garden Technologies Inc.
A1 Digital -> A1 Digital International GmbH
Vanta -> Hitachi Vantara
Coverity -> Coverity Inc.
欢聚时代 -> Joyy Inc.
Muse -> muse
Kumina -> Kumina B.V
Piksel -> Pikselpleks Labs LLC
O.S. Systems -> O.S. Systems Softwares LTDA
Creationline -> Creationline Inc.
1&1 Telecommunication SE -> 1und1 Telecommunication SE
indiehosters -> IndieHosters
CAS -> Chemical Abstracts Service
ipoque -> ipoque GmbH
Keen -> Keene State College
Comcast Cable -> Comcast
Nexenta by DDN -> Nexenta
Alluxio -> Alluxio Inc.
Akena -> AKENA
SCM Ventures -> SCM INVENTURE PVT. LTD.
Snowball -> Try Snowball
weibeld.net -> Daniel Weibel
Emindsoft -> Emind Software Co. Ltd.
Slalom -> Slalom Consulting
Red -> RED Digital Cinema Camera Company
Ampere -> Ampere Computing
Acumen Holdings -> Acumen
didi -> Xiaoju Science Technology (Hong Kong) Limited
Availity -> Availity LLC
REWE digital -> REWE Digital GmbH
Initcron -> Initcron Systems Private Limited
Argus Cyber Security -> Argus Cyber Security Ltd.
Constant Contact -> Constant Contact Inc.
The Climate -> Climate Corporation
NextGear Capital -> NextGear Capital Inc.
Mindfire -> Mind Co.ltd
HISP Tanzania -> HISP TANZANIA
Manifold -> Manifold.co
Tripwire -> Tripwire Inc.
Upland Qvidian -> Char Software Inc
Kinetica -> Kinetica DB Inc.
FAMC-Development -> FAMC
Actifio -> Actifio Inc.
Axians SE -> Axians
TSYS -> TSYS Corporation
QuantumSense -> QuantumSense Inc.
NTU CSIE WSLAB -> National Taiwan University
株式会社マネーフォワード -> Money Forward
Veepee -> vente-privee devient Veepee
EMC Isilon -> Dell Inc.
IntroPro -> Luxoft Holding Inc
Modis -> Volvo IT via Modis
CNM Consulting -> CNM Consulting Inc
CityBase -> CityBaseInc
Amplify -> Amplify Education
Traiana -> ICAP PLC (DBA as Traiana)
Google Code-in -> Google
Altisource -> Altisource Portfolio Solutions
Mobility Ware -> MobilityWare LLC
In Loco Media -> In Loco
MillenniumIT -> Millennium IT
NBCUniversal Media -> NBC Universal
Sasken -> Sasken Communication Technologies Ltd.
Harmonic -> Harmonic Inc.
Lob -> Loblaw Digital
Topicus Finan BV -> Topicus
Hogarth Worldwide -> Hogarth Worldwide Ltd.
eFolders -> Axcient Inc
Coda -> Coda Platform
SiriusXM Radio -> Sirius XM Radio Inc.
Cem - Galileo -> CEM
Topicus LegalTech -> Topicus
Smartcoder -> SMARTCODER
AdapTech -> AdapTechSolutions
Iguaz.io -> iguazio
Tufin -> Tufin Technologies
Mobilelron -> MobileIron
cellent -> x-cellent technologies GmbH
Netmonk -> NetMonk Creative Media
Blackstorm -> Blackstorm crew
Khanova škola -> Khanova ?kola
Arrow Electronics -> Arrow Electronics Inc.
Cask Data -> Cask Data Inc.
Kroger -> Kroger Co.
Marchex -> Marchex Inc.
CBRE -> CBRE Group Inc.
Rundeck -> Rundeck Inc.
Adfinis SyGroup -> Adfinis
4finance -> SIA 4finance IT Sp. z o. o. Oddziat w Polsce
Mambu -> Mambu B.V.
Otomato -> Otomato Software
Mllanox Technologies -> Mellanox Technologies Ltd
Mintel -> Mintel Group Ltd.
NAIC -> National Association of Insurance Commissioners
Gfi -> DGFIP
Open Source -> Open Source Initiative
SORINT.lab -> Sorint.lab S.p.A.
ZeniMax -> ZeniMax Media Inc
Blackbeard -> Blackbeard Hosting
EXFO -> EXFO Inc.
Convedia -> Jon Arnold
Evry ASA -> TietoEVRY
Twin Prime -> Salesforce.com Inc.
Wincorn Nixdorf -> Diebold Nixdorf
Divala -> Diwala
Fraunnhofer AISEC -> Fraunhofer-Gesellschaft
Technip -> TechnipFMC
Software & Things -> software-things
BCX -> Business Connexion
Yak Shave -> The Yak Shave
Miraki -> Miraki Tech
Istuary Innovation -> Istuary
Radio Clothing -> Radiocloth
Ancestry.com -> Ancestry.com Inc.
Prodrive -> Prodrive Technologies
Fidessa -> Fidessa Corporation
Tango -> TangoME Inc.
Sungard Availability Services -> Sungard AS
NTTPC -> Ntt Pc Communications Incorporated
Meta Networks -> Proofpoint Inc.
EXXETA -> EXXETA GmbH
TeamRock -> Louder
Everyone Counts -> Votem
Katch Up -> Katch-Up LLC
Catalyst Zero -> Giant Swarm
Pixable -> Medium
Bentley Systems -> Bentley Systems Incorporated
Trumin -> Truminds Software Systems
Rainist -> Bank Salad
STC Solutions -> Arabian Internet and Communications Services Company Ltd
Niche -> Niche.
Etix -> Etix Everywhere
AAA -> American Automobile Association
Luma -> Luma Pictures
Uniplaces -> Uniplaces Ltd.
Warner Bros -> Warner Bros. Entertainment Inc.
Schroders -> Schroder Investment Management Limited
JSC TRASTA KOMERCBANKA -> TKB
Transition Technologies - Managed Services -> Transition Technologies
Aspect -> Aspect Software Inc.
NBCUniversal -> NBC Universal
Foundries.io -> Foundries.io LTD
Appvia -> Appvia Ltd.
Gentoo -> Gentoo Linux
Fiserv Auckland -> Fiserv Inc.
Tubi TV -> Tubi
Kuri -> Kurio
Sematext Cloud -> Sematext
WildTangent -> Wild Tangent
Enea AB -> ENEA Software AB
Meggitt -> Meggitt USA
KPMG UK -> KPMG
Bonnier News -> Bonnier News Tech
Tikal - Fullstack as a Service -> Tikal development
Crunch Accounting -> Crunch
Crowe -> Crowe LLP
BSI -> Federal Office for Information Security (BSI)
Klang Games -> Klang Games GmbH
Neo -> Neo Foundation Ltd
GMO -> GMO Pepabo
Pacific Northwest National Laboratory - PNNL -> National
Optoro -> Optoro Inc.
Day by Day -> Daybyday
Siili Solutions -> Siili Solutions Oyj
Robotinfra -> RobotInfra
Ellie Mae -> Ellie Mae Inc.
METRONOM -> SC METRO SYSTEMS ROMANIA SRL
MV Corp -> MV Sport
Kontena -> Kontena Inc.
Adafruit Industries -> Adafruit
Edgecore Networks Corporation -> Edgecore Network Corporation
Smart Wires -> Smart Wires Inc.
Wolfsom -> University of Cambridge
Apalia -> Apalia SAS
HostDime -> HostDime.com Inc.
Frrole AI -> Frrole
innRoad -> innRoad Inc.
innuit -> Intuit
intuit -> Intuit
SimCorp -> SimCorp A/S
Gatsby -> GatsbyJS
AppHelp by AppDirect -> AppDirect
Name.com -> Name.com LLC
Lexmark -> Lexmark International Inc.
Sigm Informatique -> Sigma
Maginatics -> Dell Inc.
Total -> TOTAL MARKETING SERVICES
Swasth -> swasth
Tradesy -> Tradesy Inc.
Starbuck -> Starbucks Corporation
Mindtree -> Mindtree Limited
Argonne National Laboratory -> Argonne National Labs
Volvo Cars -> Volvo
Frelance -> Freelance Consulting
Emulex -> Emulex Corporation
Siteworx -> siteworX
Bitly -> Bitly Inc.
Ministère des Armées -> Ministère de la Défense
Endless -> Endless Mobile Inc.
SS&C -> SS&C GlobeOp
Combitech Sverige -> Combitech
ActiveState -> ActiveState Software Inc.
Waveroll -> F6S
Daimler FleetBoard -> Daimler
NovaTec -> NovaTech
Royal Botanic Gardens -> Kew Gardens
VTB -> JSC VTB Bank
Open Source Robotics Fundation -> Open Source Robotics Foundation
AdHoc Networks -> Adhoc Networks
Paradigma -> Paradigma Tecnológico
Puzzle ITC -> Puzzle ITC GmbH
Salmon -> Kurt Salmon
Intelerad Medical Systems -> Intelerad Medical Systems Incorporated
Hashrocket -> HASH CAPITAL GROUP LTD
Memset Hosting -> Memset
Verizon Media Platform -> Verizon
Numberly -> 1000mercis
BP Mediawork -> BP MediaWorks
AID Tech -> AID:Tech
Nextdoor -> Nextdoor.com Inc.
NetCracker -> Netcracker Technology Corporation
LFPH -> CD Non LF Test LFPH
Zone Media -> ZONE MEDIA
DaoCloud.io -> DaoCloud (Shanghai DaoCloud Network Technology Co LTD)
Apex -> Apex Supply Chain Technologies LLC
Argo -> Argo AI
communicode AG -> communicode
SFEIR -> SFEIR SA
Amicale -> Amicale Cashmere.
European Patent -> European Patent Office
Drupal -> Drupal Project
Procter&Gamble -> Proctor & Gamble Company
Threat Stack -> Threat Stack Inc.
cyber•Fund -> cyber?Fund
Blackstone -> Blackstone Group L.P.
株式会社MIN -> MINS MINIS
CloudZone -> Matrix I.T CloudZone LTD
Varonis -> Varonis Systems Ltd.
Tektronix -> Tektronix Communications
Hupp -> Hupp Technologies Pvt
Polyverse -> Polyverse Corporation
Eon -> Eon Cloud
Huddle -> HuddleUp
Sulake Dynamoid -> Sulake
SecureAuth -> SecureAuth Corporation
TÜV SÜD -> TV SD Product Service GmbH
XSKY -> XSKY Cooperation
Oscarhealth -> Oscar Health Insurance
IRCrypt -> ircrypt
freee -> freee co. ltd
NCSOFT -> NCSOFT Corporation
Wikimedia Deutschland e.V. -> Wikimedia Foundation
Rails Girls PH -> Rails Girls
Waverley -> Waverley Software
IQ Option -> IQOPTION LTD
Nemo.ai -> Visely
CyberArk -> CyberArk Software Inc.
AboutYou -> ABOUT YOU
DMM -> DMM.com Ltd.
XeThru by Novelda -> Novelda
KK VESPER -> TableCheck
ITH -> ITHAKA
Dreams -> eDreams ODIGEO
Okkur -> Okkur Labs
Kaplan -> Kaplan Inc
innoscale -> innoscale AG
NESTAPART -> Nestapart
Nubera eBusiness -> Gartner
Bird -> Bird Rides Inc.
DHL -> DHL Express
Enalean -> Tuleap-Enalean
VANTIQ -> VANTIQ Corporation
Tucows -> Tucows Hosting
lastminute.com -> lastminute
Caswell IT Consulting -> Consulting
Sela -> Sela Group
Intracom -> Intracom Telecom
Untab -> Untab Inc.
Omise Co -> Omise Co. Ltd
SpeedyCloud -> Beijing Speedy Cloud Co. LTD.
Alfacloud -> AlfaCloud
Wendu -> Century Wendu Education Technology Group
Ricardo AG -> ricardo.ch AG
ContainerStack.io -> containerstack
Emind -> Emind Software Co. Ltd.
Semihalf -> Semihalf Embedded Systems
TFG -> TFG Co
Man AHL -> Man Group
Facilet -> Facile Services Pvt
Lloyds Banking Group -> Lloyds Banking
Stardog -> Stardog Union
OCLC -> Online Computer Library Center Inc. (OCLC)
IEEE VET -> Institute of Electrical and Electronics Engineers Inc.
Nordnet Bank AB -> Nordnet Bank
CyberSource -> Cyber Source
2100Computer Lane -> Computer Lane
Arbor -> Arbor Commercial Mortgage LLC
RISTEK Fakultas Ilmu -> Universitas Indonesia
Polycom -> Polycom Inc.
State Street -> State Street Corp.
Jump Trading -> Jump Operations LLC
Guidewire -> Guidewire Software
Extreme -> Extreme Networks Inc.
Clear2Pay -> Clear2Pay Belgium
Cloud Elements -> Cloud Elements LLC
China Unicom Cloud Data Company Ltd. -> China Unicom
SVP -> SmoothVideo Project
VERISIGN -> VeriSign Inc.
BBC NEWS -> BBC
Daynix -> Daynix Computing LTD
Singlewire Software -> Singlewire Software LLC
RenderedText -> Semaphore / Rendered Text
BITMARCK -> BITMARCK Technik GmbH
Mercari US -> Mercari
Kistler -> Kistler Group
凯京科技 -> keking
xMatters -> xMatters Inc.
Mattel -> Sproutling Inc.
The Bridge Tanzania -> The Bridge TechCreative Ltd
Esper -> Esperanto Technologies Inc.
Xoriant -> Xoriant Corporation
Davidson -> Davidson Consulting
École de technologie supérieure -> École de technologie supérieure (ÉTS)
Automag -> AUTOMAG INDIA PVT
Avalanche NG -> Avalanche
Intux -> INTEX
Econocom -> Econocom USA
Redfin -> Redfin Corporation
Olivera Web -> Olivera Web Studio
IronNet -> IronNet Cybersecurity Inc
WW (formerly Weight Watchers) -> WW
zju -> Zhejiang University
Citibank -> Citi
Global Payments -> Global Payments Europe
Integrity Project -> The Integrity Project
Intermax -> Intermax Cloudsourcing
Eze Software -> Eze Software Group
InfraCloud Technologies -> Infracloud Technologies INC
Spreemo Health -> Spreemo
Helium -> Helium Systems Inc.
Dyson -> Dyson Inc.
iomed.health -> IOMED
hisilicon -> Hisilicon Technologies Co. Ltd.
The Program -> The Programming Foundation
Zenoss -> Zenoss Inc.
comScore -> comScore Inc.
PoleX -> Polex
Meituan -> Meituan-Dianping
Sapient -> Publicis Sapient
Saha -> Sahara Cluster
SaM Solutions -> SaM Solutions GmbH
Assert Selenium -> AssertSelenium
PasientSky AS -> PatientSky
Центр информационных технологий -> Information Technologies Center LLC
General Dynamics Mission Systems -> General Dynamics
Nucleus Systems -> Nucleus
AppFormix -> Appformix Inc
Smartalyse -> Smartalyse Technologies
Yaroslavl City Building College -> Yaroslavl-Online
PrismTech -> PrismTech Corporation
Tribunal -> Tribunal de Justiça do Estado de Goiás
НГС.ТЕХНОЛОГИИ (NGS.RU) -> Shkulev Media Holding
Worldbroken -> Zink Media LLC
OutagePlanner -> OutagePlanner.com
startuphero.es -> StartupHeroes
Snow day calculator -> Snow Day Calculator
Myriad Mobile -> Bushel
Pragmatics -> Pragmatics Inc.
Knowit Objectnet AS -> Knowit
Conseev -> Conseev LLC
TMP Worldwide -> TMP Worldwide Advertising & Communications LLC
Saddl -> Saddleback Leather
Go-Graphite -> Graphite
Buildit!wprodigital -> Buildit
Bonitasofts -> Bonitasoft Inc.
豆瓣 -> Douban
ETAS -> ETAL LIMITED
Mauswerks -> mausworks
Xooa -> Xooa Inc
ZFP Südwürttemberg -> Bolzplatz Eichenau
Amaiz -> AMA Group
Nuclai -> Nuclei System Technology Co. Ltd.
Fargate -> Amazon
T-Systems Iberia -> T-Systems
Kontron North America -> Kontron
TACC -> Texas Advanced Computing Center (TACC)
Aive -> Aiven Inc
Reaction -> Reaction Engineering
Ambrella -> Ambarella
Casper -> Casper College
Reinery29 -> Refinery29
Fraunhofer FKIE -> Fraunhofer-Gesellschaft
Recorded Future -> Recorded Future Inc.
Maloft Pte -> Maloft Pte Ltd.
Sigma Designs -> Sigma Designs Inc.
Thunderhead -> Thunderhead.com
GS Labs -> Great Software Laboratory Private Limited
Jacobs -> Jacobs Engineering Group Inc.
Tekion Corp -> Tekion
Zilogic -> Zillow Inc.
BSkyB -> Sky UK Limited
HONEYWELL -> Honeywell International
TelenorDK -> Telenor
Correct Context -> Correct Context Sp
Li9 -> Li9 Technology Solutions
Actionml -> ActionML
Gemini Exchange -> Gemini
Cloudify -> Cloudify Platform Ltd.
Flyndiq -> Fyndiq
coala Association -> coala
Migros Ticaret -> Migros
Allstate -> Allstate Insurance Company
Taringa -> IOV Labs
SALT Solutions AG -> Salt
Continuous Delivery -> Continuous Delivery Foundation
SiriusXM -> Sirius
Pershing -> Pershing LLC
Dronolab -> Dronolab - ÉTS
CET Costruzioni Elettroniche -> CET Electronics
AuthO -> Auth0
Sourcegraph.com -> Sourcegraph Inc
TAPSI -> Tapsi Electro medical System & services
Medicore -> MediaCore
Cadence -> Cadence Design Systems Inc.
Nelson Integration -> Nelson Integration LLC
Protacon Solutions -> Pinja
Conga -> Congatec
Falco -> Falcon.io
Zend -> Zend Technologies Ltd.
OSR Enterprises -> OSR Enterprises AG
Zephyr -> SmartBear Software Inc.
Sirius T -> Sirius
Weibo.com -> Sina Weibo
Valve -> Valve Corporation
InterContinental Hotels Group (IHG®) -> InterContinental Hotels Group
Mesa3d -> Mesa
Hostplex Hosting -> CuteStat
TVMining -> Tianmai Juyuan (Beijing) Technology Co Ltd.
Sleekcode -> the sleekcode
VK Media -> VK Media AB
INRIX -> INRIX Inc.
gravitational -> Gravitational Inc.
QIANKUN -> qiankun
ScalePlan -> spce-python
invenio -> Invenio
Guidewure -> Guidewire Software
UIC -> University of Illinois at Chicago
Nice -> NICE Netherlands B.V.
BMC True Sight -> BMC Software Inc.
Teamhephy -> Hephy Workflow
Amazon Web -> Amazon Web Services Inc.
Delivery Hero Holding -> Delivery Hero
NDSU ITS -> North Dakota State University
株式会社テクノモバイル -> Techno Mobile Co. Ltd.
Sonowflake -> Snowflake Computing Inc.
dreipunktnull -> 3
Stash -> StashAway
Google via Adecco -> Google
The Runship -> Therunship
Cyberagent -> Cyberagent Inc.
Gogo -> Gogolook Co
Agirc-Arrco -> GIRC Agirc-Arrco
K-Develop -> KDevelop
Brivo -> Brivo Systems
Aqr -> AQR Capital Management LLC
Sticket Mule -> Sticker Mule
Cineplex -> Cineplex Entertainment LP
Detecon -> Detecon International GmbH
Ness Digital Engineering -> Ness Technologies Inc.
Optimised Healthcare -> Health
Arounds -> Teamport Inc.
Vitech -> Vitech Systems Group
Mobile Technology Holdings -> MTHL
Inovonics -> Inovonics Wireless Corporation
Roorkee -> Indian Institute of Technology Roorkee
Federal Home Loan Mortgage -> Federal Home Loan Mortgage Corporation
Yippie -> Yipee.io
Ebay -> eBay Inc.
ovotech -> Egg breakers egg centrifuges egg washers - OVO-TECH
Infor PSSC -> Infor Pty Ltd
OpenReg -> OPENREG
Glosowanie.net -> ELECTOR
Accenture España -> Accenture
JRebel -> JRebel XRebel by Perforce
Yoctol -> YOCTOL.AI
CNEX Labs -> CNEX Labs Inc.
Sprouts Tech -> Sprout Technology
Somer -> Somerville House
nudge -> Nudge
Flow Tech -> Smart Information Flow Technologies (SIFT)
netbank -> Commonwealth Bank of Australia
Innominds -> Innominds Software Inc.
Cybersource -> Cyber Source
Encore -> Encored Technologies Inc.
ComSysto -> comSysto GmbH
Gaisler Research -> Cobham Gaisler
salestock -> Sorabel
Cleverbridge -> Cleverbridge Inc
Fairfield -> Fairfield University
Media Rights -> MRC II Distribution Company L.P.
Cantab Capital Partners -> Capita
Epsilon -> Epsilon Data Management LLC
Lightstreamer Srl -> Lightstreamer
Enghouse -> Enghouse Systems
CleanCodeWorks -> CleanCodeWorks stepped
ZeroG -> ZERO-G
Club Med -> Club Med India
Argo Technologie -> Argo AI
Scitor Corporation -> Science Applications International Corporation
PeerApp -> PeerApp Ltd.
Splice.com -> Splice
Anapaya -> Anapaya Systems
Iguazio -> iguazio
AlphaSense -> Alpha-Sense
Adler -> Durkopp Adler AG
Inno Power -> Innopower Technology Corporation
YouEye -> User Zoom Inc
BlueKitchen -> BTSTACK
MTN -> MTN Satellite Communications
Asml -> ASML US Inc.
Western Register -> Western Register Inc.
Latitude -> Latitude Geographics
United Overseas Bank Limited -> United Overseas Bank Limited (UOB)
Maxim Integrated -> Maxim Integrated Products
Peloton -> Peloton Technology Inc
SITA -> SITA USA
Perooz -> PEROOZ The Magazine Creator
Estateably -> Estateably Inc.
Xebia France -> xebia.fr
CloudCar™ -> CloudCar
Gemini Open Cloud -> Gemini Open Cloud Computing Inc
Praim Srl -> Praim
Ruckus Wireless -> Ruckus Wireless Inc.
El Alemán -> TALLER EL ALEMÁN
Wpro Digital -> Buildit@wprodigital
City of Philadelphia -> City of Philadelphia and Philadelphia County
ZEROFAIL Montreal -> Beanfield Technologies Inc
Raspberry -> Raspberry Pi
Rosetta Stone -> Rosetta Stone Inc.
eService -> eserviceinteractive
Planet Lia -> Lia Game
Worldline by Atos -> Worldline Global
Colony -> The Innovation Colony
Blockdaemon -> Blockdaemon Inc.
Diprotech -> DiproTech
Sapho -> Citrix Systems Inc.
Corrections.com -> corrections partners
ZPE -> ZPE Systems Inc.
Ecma -> Ecma International
Dream Production -> Dream Productions
Counselling Cell IIT Roorkee -> Wellness Center
Roku -> Roku Inc.
StateStreet -> State Street Corp.
Rayfay -> Rafay Systems
The AgileCrete Org Team -> AgileCrete
Eliassen -> Eliassen Group
AutoScout -> AutoScout24 GmbH
opsangeles.com -> Guangdong OPPO Mobile Telecommunications Corp. Ltd.
SolarCity -> SolaryCity
Kaizen -> Kaizen Platform
Harman -> Harman International Industries Inc.
Snow B.V -> Snow B.V.
ARLAN SI LLP -> Arlan Systems Integration
honeycomb -> Honeycomb
YOOX NET-A-PORTER GROUP -> YOOX NET A PORTER GROUP SPA
Insider -> Business Insider Inc.
Fast Retailing -> Fast Retailing USA Inc.
Redgate Software -> Redgate
Arango DB -> ArangoDB
SOLINOV -> solinov
Interop -> Interop Technologies
Clemson -> Clemson University
CleanSlateNow -> CleanSlateNow.
Trunk -> Trunk Club
3DSIM -> Ansys
Telia -> Telia Company AB
K2 -> K2 Inc.
ACQUIA -> Acquia Inc.
Erlang Solutions -> Erlang Solutions Ltd
TradingScreen -> TradingScreen Inc.
Bitnet Technologies -> BitNet Technology Pvt
KMS -> KMS Technology Inc.
CMD -> CMD Solutions Australia
CNEX -> CNEX Labs Inc.
Yapı Kredi -> Yapı Kredi Technology
State Key Lab of CAD&CG -> Zhejiang University
Exp:resso -> Expresso
TOTAL -> TOTAL MARKETING SERVICES
Бизнес Тренд -> Business Trend LLC
Synologa -> Synology
Pandora Media -> Pandora Media Inc
Mitel -> Mitel Networks Corporation
Token858 Capital -> Capita
iHeart Media -> iHeartMedia Inc
NetlifyCMS -> Netlify
Publicis Groupe -> Publicis
bexio AG -> bexio
FreeBSD Foundation -> The FreeBSD Foundation
JBA -> JBAT
Open Collector -> Open Porn Network
Roburio -> robur
Zeekit -> Zeekit Online Shopping Ltd
Distributed Systems Laboratory -> University of Pennsylvania
Embraer -> Embraer Aircraft Maintenance Services Inc
Vainu.io -> Vainu
Aiko Systems -> AIKO SYSTEM
TV 2 DANMARK -> TV 2
NetDev -> The NetDev Society
Informa -> Informa North America
NTUA -> National Technical University of Athens
Nottle -> The Nottle Co
ThinkingPhones -> FuzeInc.
ZeOmega -> ZeOmega Inc.
wix.com -> Wix.com Ltd
VodafoneZiggo -> Vodafone Group Services Limited
CNA Insurance -> CNA Financial Corporation
Savari -> Savari Inc
Avvasi -> Avvasi Incorporated
Petback -> PetBack
CompuGroup -> CompuGroup Medical USA
OpsGuru -> OpsGuru.io
IIIT-DElhi -> IIIT Delhi India
ZJU -> Zhejiang University
10th Magnitude -> 10th Magnitude Inc.
NatWest Markets -> NatWest
Steria -> Sopra Steria
Taobao Marketplace -> Taobao
Bunchball -> Bunchball inc.
Networked Insights -> American Family Insurance
CLSA -> CLSA Americas
Aragon DAC -> Medium Corp.
Styler -> styler mobility
Oracle India Pvt -> Oracle India Pvt. Ltd.
Rogue Wave Software -> Rogue Wave Software Inc.
AMEX -> LoyaltyEdge from American Express
Intranisition -> Itransition
Fraunhofer FOKUS -> Fraunhofer-Gesellschaft
De Persgroep -> DPG Media
UW-Madison -> Space Science & Engineering Center University of Wisconsin-Madison
InfluxDB -> InfluxData Inc
Winder Research -> Phil Winder
kakao -> kakaobank
Bustle Digital -> Bustle
DRUD Tech -> Drud Technology LLC
Hedera Hashgraph -> Hedera Hashgraph LLC
Crédit Agricole -> Credit Agricole Americas
CertusNet -> CertusNet Inc.
CloudBolt -> CloudBolt Software
IoT bzh -> IoT.bzh
Brandbury Lab -> Bradbury Lab
REWE Digitl -> REWE Digital GmbH
Harbur -> Harbur Cloud Solutions
Logz -> Logz.io
InterCollect -> INTERCOLLECT GROUP LTD
YesMastr -> YesMaster
RStudio -> RStudio PBC
Dialog Axiata -> Dialog Axiata PLC
Sixgill -> Sixgill LLC
Kobo -> Kobo Inc.
ASKUL -> ASKUL Corporation
Leonardo -> Leonardo S.p.A.
Sonrai -> Sonrai Security
QiO -> QiO Technologies
Code for Science and Society -> Code for Science & Society
AMETEK -> Vision Research
Bloks -> eosio
Oblong Industries -> Oblong
Software Freedom Conserwancy -> Software Freedom Conservancy
Kingsoft -> Beijing Kingsoft Cloud Internet Technology
Dreamworks -> DreamWorks Animation
Newlogic -> Newlogic Impact Lab
COBI.Bike -> Bosch eBike Systems
bengo -> Abengoa
ASTRI -> Hong Kong Applied Science and Technology Research Institute Company Ltd
Guidance -> Guidance Software Inc.
Peak6 -> PEAK6 Investments L.P.
Mistbase -> Arm Ltd
Bosho Technologies -> Basho Technologies Inc.
ITK Engineering -> ITK Engineering GmbH
Poki -> PokitDok
Jumpin -> Jumping Bean
BroadridgeFinancial Services  Ne -> Broadridge
Ingics -> INGICS TECHNOLOGY
Bitcoin -> Bitcoin Foundation
CloudChef -> CloudChef.tech
Miracle Linux -> Cybertrust Japan Co. Ltd.
Fly.io -> Fly.io Inc.
Micro Strategy -> MicroStrategy Inc
ADLINK -> ADLINK Technology Inc.
Exaring AG -> Exaring
Chunghwa -> Chunghwa Telecom
Baloise Insurance -> Baloise
Web Summit -> Connected Intelligence Limited
Hashi -> HashiCorp
Gamesys -> Gamesys group
ASRC Federal Vistronix -> ASRC Federal
Vzar -> F6S
Wombat -> Wombat Software UG
Vernacular -> Vernacular.ai
Santander -> Banco Santander
OpenWISP -> OpenWI
lunar way -> Lunar Bank A/S
Bouvet ASA -> Bouvet
JD Digits -> Chinabank Payments
Socrata -> Socrata Inc.
Equalibra -> Эквалибра
SIXT -> SIXT R&D India Pvt. Ltd.
McGrow-Hill Education -> McGraw Hill
Kforce -> Kforce Inc.
Soonr -> Datto Inc
SBCloud -> SB Cloud
Jetlore -> PayPal Holdings Inc
ZeroLatency -> ZeroLag Communications Inc.
Cosmo -> Cosmo Software Consulting Private Ltd.
Flavia IT -> FLAVIA IT-Management
ISA Research -> ISA Research Committee 22
SHN -> VSHN AG
Japan Perl Association -> JPA
Verk -> Verkada
QCT -> Quanta Cloud Technology Inc.
MetaX -> MetaXchain
Stefanini Brasil -> Stefanini
Enea -> ENEA Software AB
Open source -> Open Source Initiative
Summatrix -> CuteStat
Publicis Media -> Publicis
Yum! Brands -> Yum! Brands Inc.
Aruba Networks -> Aruba Networks Inc.
Raspberry Pi Foundation -> Raspberry Pi
CoreLogic -> CoreLogic Inc.
Full Stack Dev -> Full Stack
Dun & Bradstreet -> Dun & Bradstreet Corporation
Blockchain.io -> Blockchain
恩普特 -> Empote
Reliance Industries Limited -> RJIL
Accenture in India -> Accenture
Lowe's Companies -> Lowe's Companies Inc.
Devguard -> devguard.io
Catalogic -> Catalogic Software
Carrot Creative -> Vice Media LLC
Workshop -> The Workshop
STIM -> STIMIO
Akana -> Akana Inc.
Agari -> Agari Data Inc
Creater Commons -> Creative Commons
Dell KACE -> Quest Software Inc
Marktplaats -> Marktplaats B.V.
Exati -> Blacksmith-Labs
Fujitsoft -> Fujisoft Incorporated
Rethink -> RethinkDB
Jabong -> Flipkart Online Services Pvt. Ltd.
ownCloud -> ownCloud Inc.
Ruby -> Ruby on Rails
Vuforia -> PTC Inc
Alcatel -> Alcatel Canada
Solutions Plus -> SOLUTIONSplus Project
The Zephyr -> Zephyr Project
Counsyl -> Counsyl Inc.
AtherEnergy -> Ather Energy Pvt Ltd
DevOps Porto meetup -> MeetUp
IGATE -> iGATE Corporation
Fazlamesai -> fazlamesai.net
Cree -> Cree Inc.
Survey Sampling -> Survey Sampling International LLC
Trip Nation -> Tripnation
DropHops -> DropHop
Frankly.me -> Frankly
Travix -> Travix Nederland BV
SoftwareONE -> SoftwareONE USA
Python Software Fundation -> Python Software Foundation
Notional Builder -> 3dna Corp.
ASP -> ASPE Inc.
Amplifier -> Amplifi
MediaNet -> Media.net Ltd
Xevo -> Xevo (formerly UIEvolution)
Vogelaar -> Vogelaar Vredehof
Stepwise Analytics -> Stepwise LLC
Lithient -> Tracxn Technologies Private Limited
Permanent -> Kaiser Permanente
Groupe -> Groupe PSA
finleap -> finleap connect GmbH
Power Home Remodeling Group -> Power Home Remodeling Group LLC
EFACTORY -> Missouri State University
Manumitting -> Manumitting Techn
Sanmina -> Sanmina Corporation
Optus -> Singtel Optus
Discovery -> Discovery Communications
Tembo -> Temboo
Iseit -> Acronym Finder
Eurotech -> Eurotech S.p.A.
Expansion -> Glass Expansion
Payara -> Payara Services Limited
SS&C Advent -> Advent Software Inc.
Bayara -> BAYARA
Korn Ferry -> Korn Ferry International
JobCouch -> huge domains
twitch.tv -> Twitch
LoudDoor -> LoudDoor LLC
i2CAT -> i2CAT Foundation
Blameless -> Blameless Inc
ScriptDash -> ScriptDash Inc.
Fujitsu Estonia -> Fujitsu
TUBITAK -> TUBITAK UEKAE
Dealer. -> Dealer.com
Ultimate -> Ultimate Software
Very Good -> Very Good Security
Unique Cinema Systems -> Uniplaces Ltd.
NRI -> INRIX Inc.
Bizo -> LinkedIn Corp.
Johnko -> Johnko Express
actimeo -> Actimeo
Network Radius -> Radiator Software
Rabobank ICT -> Rabobank
Rohde & Schwarz GmbH & Co. KG -> Rohde & Schwarz GmbH & Co. KG Dept. 1GS3
Endeavor Robotics -> FLIR Systems Inc.
JIMU -> jimu
Kymeric -> Kymeric Technologies
Electric Cloud -> Electric Cloud Inc.
Hotelicom Networks -> SmartCast Inc.
Zoku -> Zoku LLC
Bikeemotion -> bikeemotion
Rally Software -> Rally Software Development Corp.
Threadless -> Skinnycorp LLC
Telemetry -> BioTelemetry
Live Journal -> Live Journal Inc
Spaceflight I -> Spaceflight
Tim Carr -> TIM CARR
CGI France -> CGI
Umbel -> Umbel Corp.
Dassault Systèmes -> Dassault Systemes North America
Vertafore -> Vertafore Inc.
Foresight Investments -> Foresight
Josh -> Josh Bell
Opendor -> OpenDor Media
Accord -> Accord Project LLC
中科院计算技术研究所 -> Institute of Computing Technology Chinese Academy of Sciences
HaxFundation -> HAX FUND
DIRECTTV -> DirecTV
Operable -> GitHub Inc.
Kodiak -> Kodiak Networks
Lithium Technologies -> Lithium Technologies Inc.
TCL Corporate Research -> TCL Corporate Research (Hong Kong) Co Limited
Cloudway -> Cloudways
Tribune Media Services -> Tribune Media
Renault-Nissan-Mitsubishi -> Renault Nissan
Agilysys -> Agilysys Inc.
Atmark Techno -> Atmark Techno Inc.
Mashape -> Mashape API Marketplace
RT-RK -> RT-RK Computer Based Systems LLC
Dgraph-io -> Dgraph Labs Inc.
Amigo -> AmigoCloud
Holis -> Holisticon AG
Helico -> Helico - Medical Devices
Lancope -> Cisco
PushApps -> Pushapp
YouGov Signal -> YouGov
Swarco Nordic -> SWARCO
BBC Children in Need -> BBC
RX-M -> RX-M LLC
Mandriva -> Mandriva S.A.
BasysKom -> basysKom GmbH
Proxmox -> Proxmox Server Solutions GmbH
Shadow-soft -> Shadow-Soft LLC
Human Longevity -> Human Longevity Inc.
ICS-FORTH -> FORTH
Sovrn Holdings -> Sovrn
Noa -> NOAA
Qualys -> Qualys Inc.
Talos -> Talos Systems
Hut8Labs -> Hut 8 Labs
Combell -> Openminds bvba
PNNL -> Pacific Northwest National Laboratory
Arkéa -> Fédéral Service Crédit Mutuel Arkéa
Camelot -> Camelot Business Solutions Limited
raywalker.it -> raywalker
Kpit -> KPIT Technologies Limited
Sequans -> Sequans communication
Micronova srl -> Micronova
Cubarte -> periodico Cubarte
RB -> Reckitt Benckiser (North America) Inc.
Jabil -> Jabil Circuit Inc.
Compile -> Hunan Compiler Information Technology Co. Ltd
Teradata Aster -> Teradata
Saleforce -> Salesforce.com
NCTU -> National Chiao Tung University (NCTU)
Sky Betting -> Sky Betting and Gaming
Fast White -> Fast White Cat
Positive -> Positive s.r.o.
E.ON Digital Technology -> Eon Cloud
Twinfield -> Wolters Kluwer
Riverbed Technology -> Riverbed Technology Inc.
Noiseless Acoustics -> NL Acoustics
Arismore -> Accenture Global Solutions Limited
Igneous -> Igneous Systems
Via Oncology -> Elsevier
HOT -> DAILYHOTEL
Amagroup -> AMA ARCHITECTS
Clifton -> Clifton Trends Private Limited
Nerim -> NERIM Group of Institutions
Upsolver -> Upsolver Inc.
Akelius Residential -> Akelius Residential Property AB
Varian -> Varian Medical Systems
Eneco Energy -> Eneco Energy Limited
Finciero -> F6S
Blue Fox -> Bluefox Restaurant
PennState -> Penn State
Google Summer -> Google
ESET -> ESET North America
FAYN -> Fayn
AutoScout24 -> AutoScout24 GmbH
DreamBox.com -> Dreambox Learning
Kinsta -> Kinsta Ltd.
Monsanto -> Monsanto Company
Symbiont -> Symbiont.io Inc.
Svenska Middlewaregruppen -> Svenska Middlewaregruppen AB Org.
Yinnut -> RIPRO
Auzom Entertainment -> Auzom
Activision Blizzard -> Activision Blizzard Inc
thePlatform -> thePlatform for Media Inc.
Scaler Labs -> scalarlabs
Cogent Embedded -> Cogent Embedded Inc.
GumGum -> GumGum Inc.
Knight -> Knight Watch
Raleigh -> City of Raleigh
Waves Tech -> GreenWaves Technologies
x-ion -> Xion Protective Gear
The Hartford -> Hartford Financial Services Group Inc.
Momentum -> Momentum Dashboard
ntes -> NTES GmbH Windkraftservice
Fides -> Fidessa Corporation
GM -> General Motors
Infomaniak Network -> Infomaniak Network SA
WELT corp -> WELT
ADVA -> Adva Optical Networking SE
Keymetrics -> Keymetrics Inc
Newtek Business Services -> Newtek
Devoxx4Kids -> Devoxx4Kids USA
Digi-Key -> Digi-Key Corporation
Haufe -> Haufe Discovery GmbH
PA Consulting -> PA Consulting Holdings Limited
Zeitspace -> Zeitspace Inc
Nexica -> Nexica Econocom
msg systems -> msg
Granite -> Granite Digital
Делимобиль -> Delimobil
Bloomberg Industry -> Bloomberg
Bethesda -> Bethesda Softworks
Digiwin -> Digiwin Software
Cyrus -> Cyrus Biotechnology
Private Consulting -> Private Consulting s.à r.l.
Abyeti -> Abyeti Technologies
DVLA -> Driver and Vehicle Licensing Agency
Michelin -> Michelin North America Inc.
Surrey -> University of Surrey
Topicus.Education -> Topicus
Pillar -> 3Pillar Global
ZBJ -> zbj.com
SpotHero -> Spot Hero
Daimler Trucks Asia -> Daimler
H&R Block -> H&R Block Inc.
Allterco Robotics -> ALLTERCO
LifeWay -> LifeWay Christian Resources
Ping Identify -> Ping Identity Corporation
Traum -> Happy Traum
Bossa Nova Robotica -> Bossa Nova Robotics
Concentra -> Concentra Inc.
Cumulocity -> Cumulocity GmbH
Product Ops -> productOps
MeetSpace -> Meet Space
COLT -> Colt Telecom Services AG
Resurs Bank -> Resurs Bank AB
TEDxHackney -> TED Foundation Inc
Syntel -> Syntel Inc
iSense -> SiSense
MarkLogic -> MarkLogic Corporation
Atihita -> Lambda Linux Project
Wisma -> University of Technology Business and Design in Wismar
Utility Warehouse PLC -> Utility Warehouse
Ascent Robotics -> Ascent
SequencelQ -> Cloudera Inc.
iborn -> MaibornWolff
Susquehanna International Group -> Susquehanna
Rovi -> Rovi Corporation
Millennium -> Millennium Management LLC
SiGHUP -> SIGHUP s.r.l.
Oberthur Technologies -> Oberthur Technologies (US)
Infinera -> Infinera Corporation
Synerzip -> Synerzip Softech India Pvt LTD
CG Power and Industrial -> CG Power and Industrial Solutions Limited
Miras Uniwersity -> MIRAS EDUCATION
Dashine -> DASHINE ELECTRONICS CO
JDA Software -> JDA Software Group
KAWANET -> kawa.net
OSS -> OSS Capital
VivaRealBrasil -> VivaReal
Chronosphere -> Chronosphere Inc.
Redflex -> Redflex Traffic Systems
CENX -> CENX Inc.
Microsemi -> Microsemi A/S
Cypress Semiconductor Corporation -> Cypress Semiconductor
Precisely -> Precisely Holdings LLC
lden Delicious Computers GmbH&Co -> Golden Deli. Comp.
Piedmont -> Central Piedmont Community College
Ricardo -> ricardo.ch AG
ZF Group -> ZF North America Inc.
Alphacomm B.V. -> Alphacomm
Novozymes -> Novozymes Biologicals Inc.
Cimpress-MCP -> Cimpress plc
Watchup -> Plex Inc
Kitware -> Kitware SAS
Zenus Biometrics -> Zenus Inc
Upgrade -> Upgrade Inc.
Deepfield Networks -> Nokia Corporation
Accenture The Netherlands -> Accenture
Ascent Networks -> Ascent
Vube -> VUBE
Fixstars -> Fixstars Corporation
IIJ Innovation -> IIJ Innovation Institute Inc.
Infomaniak -> Infomaniak Network SA
NetBase -> NetBase Quid
之江实验室 Zhejiang -> 之江实验室 Zhejiang Lab
YourHelpingHand -> Your Helping Hand
Alaska Airlines -> Alaska Air Group
Newmount Mining -> Newmont Mining Corporation
Cloud Security -> Cloud Security Alliance
Promontory Interfinancial Network -> Promontory Interfinancial Network LLC
Brujula d' esplai Binitrui -> Brujula
Act-On Software -> Act-On Software Inc.
Futurewei -> Futurewei Technologies Inc.
KCG Holdings -> Virtu Financial Inc.
Various Companies -> Various
ICANN -> Internet Corporation for Assigned Names and Numbers
Hippo Drs -> Hippo Drs.
Pacific Life -> Pacific Life Insurance Company
OpenMesh -> Ope-Mesh
Wanclouds -> Wanclouds Inc.
Sampo Software -> Sampo Software Oy
Vantiv -> Fidelity National Information Services Inc
KPMG Singapore -> Singapore
Antares -> Antimatter Studios
Zeta Global -> Zeta Interactive Corp.
Ahold -> Ahold Delhaize USA
MedMera Bank AB -> TheBanks.eu
OpenNetSys -> NetSys
Ramsgate Engineering -> RAMSGATE ENGINEERING INC.
LogMeln -> LogMeIn
Alcoa -> Alcoa Inc.
CITIC -> CITIC Group Corporation
Centro de inovação - EDGE -> Edge
Integra Sistemi -> Integra Systems
Verify -> DoubleVerify
geopy -> PyPI
pair -> pair Networks
Bgmenu -> Takeaway.com
Ascent RegTech -> Ascent
Smartrac -> SMARTRAC N.V
Лига Ставок -> League of Bets
Squared -> Schneider Electric
Adjust -> Custard Insurance Adjusters Inc.
Altitude -> Altitude Angel
Appthority -> Appthority Inc
Amrita -> Amrita Vishwa Vidyapeetham
Bit Flippers -> RobotInfra
Otono Networks -> IDEMIA
OCTADEV TN -> OCTADEV
Red Yak -> RED YAK
Adecco -> Adecco Group
Soficom -> Social Finance (SoFi)
Relo -> Reload A/S
Hootsuite Media -> Hootsuite
APIMatic -> APIMatic Limited
Trulia -> Trulia Inc.
CloudCentral -> Cloud Central Pty Ltd
Zeffi -> ZEF Ltd
SapientNitro -> Publicis Sapient
Postgres Profesional -> Postgres Professional
Raise.com -> Raise Marketplace Inc.
AdaCore -> ADACORE INC
The Travel -> TheTravel
Windstream -> Windstream Communications
T4G -> T4G Limited
Envipartner -> ENVIPARTNER
Drinker Biddle & Reath -> Faegre Drinker
SCSK -> scsk corporation
UserZoom -> User Zoom Inc
Chroma Estudioa -> Chroma
Daptiv -> Changepoint
Tai-Dev -> tai-dev
Beyond the Rack -> BTR
Crash Course -> CrashCourse
BMO Financial Group -> Bank of Montreal
NCR Corporation -> NCR
NTT DATA UK -> NTT DATA
Proxima Web -> Proxima
Philip -> PHILIPS ELECTRONICS NA CO
Clevertch -> Clevertech
SoftLayer -> SoftLayer Dutch Holdings B.V.
Curity -> Curity AB
Thetus Corporation -> Savanna
Cyient -> Cyient Limited
Aliyun -> Alibaba Cloud
VSP Global -> Vision Service Plan dba VSP Global
One Source -> One Source Integrations
Scan Trust -> Scantrust
KIT-AR Ltd -> KIT-AR
Jungle Genius Business Technology Solutions -> Jungle Genius
Homes for Hsringey -> Homes for Haringey
Rahi Systems -> Rahi Systems Inc
Intuit India -> Intuit Inc.
Adhara -> Adhara Limited
Actian -> Actian Corporation
Crunch-accounting -> Crunch
Lattelecom -> SIA Lattelecom Tehnology
Bright Box -> Bright Box Limited
Bobs Oil Field Service -> Bob’s Oilfield Service
Astrafox -> ASTRAFOX
Anders Inno -> Anders Innovations Oy
Waitrose & Partners -> Waitrose
SAMSUNG -> Samsung Electronics Co. Ltd.
KONUX -> Konos & Lux Ltd
Costco Wholesale -> Costco Wholesale Corporation
NAVIGATOR -> Mozilla Corporation
WhizUs -> WhizUs GmbH
Merck & Company -> Merck & Co. Inc.
Malt -> Government of Malta
Woodward Poland -> Woodward Inc.
42 Tech -> 42TECH
Imaginea Technologies -> Imaginea Technologies Inc
Time -> Time Inc.
MD Systems -> material data system
Polaris Alpha -> Parsons
IOTech -> IOTech Systems Limited
AOk Networks -> AOK Networks
mindkeeper -> mindkeeper solutions GmbH
VIAVI Solutions -> Viavi Solutions Inc.
Derivco -> Derivco IOM
Prezi -> Prezi Inc.
Philips Dynalite -> Dynalite
Rapiscan -> Rapiscan Systems
Certified -> ExitCertified
DBS -> DBS Bank
Aurora Borealis technologies -> Aurora
balena -> Balena Inc.
Buildit @ Wipro Digital -> Buildit
Teem by WeWork -> WeWork
China Unicom Research Institute -> China Unicom
truenova -> True Nova
TEDxLugano -> TED Foundation Inc
ASTEK -> Astek Corporation
Presidio -> Presidio Inc.
Symphony RetailAI -> Symphony
Digitalis -> Digitalist Group Oyj (formerly) Ixonos Plc
General Asembly -> General Assembly
CockroachDB -> Cockroach Labs
Accenture Belgium -> Accenture
CCAC -> Community College Allegheny County
CognitiveID -> COGNITIVE ID LTD
ZJU-SEL -> Zhejiang University
Animal Creek -> Animal Creek Technologies
TEDxIIT Hyderabad -> IIT Hyderabad
JobDash -> JobDASH
Linker -> Linker Networks
Clouds Sky -> Clouds Sky GmbH
OSDC.TW -> OSDC
Defence Research -> DRDO
Blue Cross Blue Shield of North Dakota -> Blue Cross Blue Shield Association
e-Spirit AG -> e-Spirit
Hyperjump -> Hyperjump Technology
Redbox Automated Retail -> Redbox
Olga’s Home Helpers -> Olga?s Home Helpers
KVH -> KVH Industries Inc.
Solum Solutions -> solumsolutions
Neural Engineering Data Consortium -> Institute for Signal and Information Processing
Shadow-Soft -> Shadow-Soft LLC
Hamilton -> Hamilton Company
Timshel -> Mysite
МТС -> МТS
Manulife -> Manulife Financial
cosee -> cosee GmbH
